{
    "id":"001",
    "textures":{
      "back":"client/assets/environment/back.png",
      "middle":"client/assets/environment/middle.png",
      "tileset":"client/assets/environment/tileset.png"
    },
    "texture_atlases":{
      "hearts":"client/assets/atlas/hearts.json",
      "items":"client/assets/atlas/items.json",
      "props":"client/assets/atlas/props.json",
      "sprites":"client/assets/atlas/sprites.json"
    },
    "layers":[{
      "id":"collision_0",
      "cacheAsBitmap":false,
      "columns":48,
      "rows"   :32,
      "tile_set":"tileset",
      "tile_set_col":25,
      "tile_size":16,
      "offset_x":0,
      "offset_y":0,
      "parallax_speed_x":1,
      "parallax_speed_y":1,
      "scale":1,
      "tint":null,
      "tile_map":null,
      "tile_map_offset":16,
      "tiling_sprite":null,
      "collision_map":[
        0,0,10,0,0,0,0,0,0,0,0,0,0,0,0,0,0,0,0,0,0,0,0,0,0,0,0,0,0,0,0,0,0,0,0,0,0,0,0,4,0,0,0,0,0,0,0,0,
0,0,10,0,0,0,0,0,0,0,0,0,0,0,0,0,0,0,0,0,0,0,0,0,0,0,0,0,0,0,0,0,0,0,0,0,0,0,0,0,4,14,0,0,0,0,0,0,
0,0,0,9,0,0,0,0,0,0,0,0,0,0,0,0,0,0,0,0,0,0,0,0,0,0,0,0,0,0,0,0,0,1,15,9,0,0,0,0,0,0,2,0,0,0,0,0,
0,0,0,10,0,0,0,0,0,0,0,0,0,0,0,0,0,0,0,0,0,0,0,0,0,0,0,0,0,0,0,0,0,2,0,10,0,0,0,0,0,0,4,0,0,0,0,0,
0,0,0,10,0,0,0,0,0,0,0,0,0,0,0,0,0,0,0,0,0,3,13,13,15,15,15,15,9,0,0,0,0,2,0,0,15,9,0,0,0,0,0,2,0,0,0,0,
0,0,0,0,15,15,9,0,0,0,0,0,0,0,0,0,0,0,0,0,0,0,0,0,2,0,0,0,10,0,0,0,0,2,0,0,0,10,0,0,0,0,0,2,0,0,0,0,
0,0,0,0,0,0,0,15,15,15,15,15,9,0,0,3,15,15,11,0,0,0,0,0,2,0,0,0,10,0,0,0,1,0,14,14,14,12,0,0,0,0,0,2,0,0,0,0,
0,0,0,0,0,0,0,0,0,0,0,0,10,0,0,0,2,10,0,0,0,0,0,0,2,0,0,0,0,11,0,0,2,10,0,0,0,0,0,0,0,0,0,2,0,0,0,0,
0,0,0,0,0,0,14,14,14,0,0,0,0,15,15,15,0,0,15,15,15,15,15,15,0,0,0,0,10,0,0,3,0,10,0,0,0,0,0,0,0,0,0,2,0,0,0,0,
0,0,0,0,0,10,0,0,0,4,14,0,0,0,0,0,0,0,0,0,0,0,0,0,0,0,14,0,10,0,0,0,2,0,13,11,0,0,0,0,0,0,0,2,0,0,0,0,
0,0,0,0,0,10,0,0,0,0,0,4,0,14,14,14,14,14,14,0,14,14,14,14,14,12,0,4,12,0,0,0,2,10,0,0,0,0,0,0,0,0,0,2,0,0,0,0,
0,0,0,0,0,0,9,0,0,0,0,0,6,0,0,0,0,0,0,6,0,0,0,0,0,0,0,0,0,0,0,0,2,10,0,0,0,0,0,0,0,0,0,2,0,0,0,0,
0,0,0,0,0,0,10,0,0,0,0,0,0,0,0,0,0,0,0,0,0,0,0,0,0,0,0,0,0,0,0,0,2,10,0,0,0,3,13,13,13,13,13,14,14,0,0,0,
0,0,0,0,0,0,0,9,0,0,0,0,0,0,0,0,0,0,0,0,0,0,0,0,0,0,0,0,0,0,1,15,0,10,0,0,0,0,0,0,0,0,0,0,0,2,0,0,
0,0,0,0,0,0,0,0,15,9,0,0,0,0,0,0,0,0,0,0,0,0,0,0,0,0,0,0,1,15,0,0,0,10,0,0,0,0,0,0,0,0,0,0,0,2,0,0,
0,0,0,0,0,0,0,0,0,10,0,0,0,0,0,0,0,0,0,0,0,1,15,15,9,0,0,0,2,0,0,0,0,14,11,0,0,0,0,0,0,0,0,0,1,0,0,0,
0,0,0,0,0,0,0,0,0,10,0,0,0,0,0,0,0,0,0,0,0,2,0,0,10,0,0,0,2,0,0,0,12,0,0,0,0,0,0,0,0,0,0,3,0,0,0,0,
0,0,0,0,0,0,0,0,0,10,0,0,1,15,15,15,15,15,15,15,15,0,0,0,0,15,15,15,0,0,0,12,0,0,0,0,0,0,0,0,0,0,0,0,4,14,0,0,
0,0,0,0,14,14,14,14,14,10,0,0,2,0,0,0,0,0,0,0,0,0,14,14,14,14,0,0,0,0,10,0,0,0,0,0,0,0,0,0,0,0,0,0,0,0,2,0,
0,0,0,10,0,0,0,0,0,6,0,0,2,0,0,0,14,14,14,14,14,12,0,0,0,0,4,0,0,0,12,0,0,0,0,0,0,0,0,0,0,0,0,0,0,0,2,0,
0,0,0,10,0,0,0,0,0,0,0,0,2,14,14,10,0,0,0,0,0,0,0,0,0,0,0,2,0,10,0,0,0,1,15,15,15,15,15,15,15,15,15,15,9,0,2,0,
0,0,0,10,0,0,0,0,0,0,0,0,6,0,0,6,0,0,0,0,0,0,0,3,11,0,0,2,0,12,0,0,0,2,0,0,0,0,0,0,0,0,0,0,10,0,2,0,
0,0,0,10,0,0,0,0,0,0,0,0,0,0,0,0,0,3,13,11,0,0,0,0,0,0,0,2,12,0,0,0,0,2,0,0,0,0,0,0,0,0,0,0,10,0,2,0,
0,0,0,0,15,15,15,15,15,9,0,0,0,0,0,0,0,0,0,0,0,0,0,0,0,0,0,6,0,0,0,1,15,0,0,0,0,0,0,0,0,0,0,0,10,0,2,0,
0,0,0,0,0,0,0,0,0,0,15,15,9,0,0,0,0,0,0,0,0,1,13,13,11,0,0,0,0,0,1,0,0,0,0,0,0,0,0,0,0,0,0,0,10,0,2,0,
0,0,0,0,0,0,0,0,0,0,0,0,10,0,0,0,0,0,3,13,13,12,0,0,0,0,0,0,0,0,2,0,0,0,0,0,0,0,0,0,0,14,14,14,12,0,2,0,
0,0,0,0,0,0,0,0,0,0,0,0,0,9,0,0,0,0,0,0,0,0,0,0,0,0,7,0,1,15,0,0,0,0,0,14,14,0,0,0,12,0,0,0,0,0,2,0,
0,0,0,0,0,0,0,0,0,0,0,0,0,0,15,15,9,0,0,0,0,0,0,1,15,15,0,15,0,0,0,0,0,0,10,0,0,4,14,12,0,0,0,0,0,0,2,0,
0,0,0,0,0,0,0,0,0,0,0,0,0,0,0,0,0,15,15,15,15,15,15,0,0,0,0,0,0,0,0,0,0,0,10,0,0,0,0,0,0,0,0,0,7,0,2,0,
0,0,0,0,0,0,0,0,0,0,0,0,0,0,0,0,0,0,0,0,0,0,0,0,0,0,0,0,0,0,0,0,0,0,10,0,0,0,0,0,0,0,0,1,10,0,2,0,
0,0,0,0,0,0,0,0,0,0,0,0,0,0,0,0,0,0,0,0,0,0,0,0,0,0,0,0,0,0,0,0,0,0,0,15,15,15,15,15,15,15,15,0,0,15,0,0,
0,0,0,0,0,0,0,0,0,0,0,0,0,0,0,0,0,0,0,0,0,0,0,0,0,0,0,0,0,0,0,0,0,0,0,0,0,0,0,0,0,0,0,0,0,0,0,0
        ],
        "collectibles":[
            ["aaab",112,328,16,16],
            ["aaac",664,80,16,16],

            ["aaba",264,32,16,16],
            ["aabb",112,160,16,16],
            ["aabc",544,8,16,16],

            ["aaca",248,400,16,16],
            ["aacb",376,312,16,16],
            ["aacc",568,448,16,16],

            ["bb",483,370,10,10],

            ["acda",488,184,16,16],
            ["acdb",80,328,16,16],
            ["acdc",552,120,16,16]
          ],
          "platforms":[
              ["ab","s",{"x":256,"y":60},32],
              ["ab","s",{"x":472,"y":160},32],
              ["ab","s",{"x":592,"y":240},32],
              ["ab","s",{"x":640,"y":240},32],
              ["ab","d",{"x":208,"y":240},32,{"x":192,"y":240},{"x":240,"y":240}],
              ["ab","d",{"x":272,"y":240},32,{"x":256,"y":240},{"x":304,"y":240}]
            ],
          "player_spawns":[
                [78,60,32]
            ],
          "spawns":[
            ["eagle_ai_1","patrol",411,216,1,1,"right"],
            ["eagle_ai_1","patrol",168,216,1,1,"right"],
            ["eagle_ai_0","patrol",630,272,1,1],
            ["fox_ai_0","patrol",272,80,1,1],
            ["fox_ai_0","patrol",396,48,1,1],
            ["fox_ai_0","patrol",420,48,1,1],
            ["fox_ai_0","patrol",368,224,1,1],
            ["fox_ai_0","patrol",368,368,1,1],
            ["fox_ai_0","patrol",320,430,1,1],
            ["fox_ai_0","patrol",608,304,1,1],
            ["fox_ai_0","patrol",656,304,1,1],
            ["fox_ai_0","patrol",640,176,1,1],
            ["fox_ai_2","patrol",297,336,1,1],
            ["frog_ai_0","jump",160,80,1,1,"left"],
            ["frog_ai_0","jump",586,48,1,1],
            ["frog_ai_0",null,608,465,1,1]
          ],
          "triggers":[
              ["damage",208,121,48,10],
              ["damage",288,121,96,10],
              ["damage",192,265,144,10],
              ["damage",400,265,48,10],
              ["damage",304,192,16,10],
              ["damage",192,192,16,10],
              ["damage",208,336,32,10],
              ["damage",272,368,48,10],
              ["damage",288,416,64,10],
              ["damage",368,352,32,10],
              ["damage",352,400,48,10],
              ["damage",720,472,16,10]
            ]   
    },{
        "id":"bg1",
        "cacheAsBitmap":true,
        "columns":48,
        "rows"   :32,
        "tile_set":"tileset",
        "tile_set_col":25,
        "tile_size":16,
        "offset_x":0,
        "offset_y":0,
        "parallax_speed_x":1,
        "parallax_speed_y":1,
        "scale":1,
        "tint":null,
        "tile_map":[
            95,95,97,0,0,0,0,0,393,394,471,471,396,397,0,0,0,0,0,0,0,0,0,393,394,471,471,396,397,0,0,0,0,0,0,0,0,0,0,268,269,95,95,95,95,95,95,95,
199,95,97,193,0,0,0,0,0,419,471,396,397,0,0,0,0,0,0,0,0,0,0,0,419,471,471,421,0,0,0,0,0,0,193,0,0,0,0,0,268,145,269,95,95,95,95,95,
95,95,49,47,0,0,0,0,443,444,396,397,0,0,0,0,0,0,0,0,0,0,0,443,444,471,471,446,447,0,0,0,0,43,45,47,0,0,0,0,0,203,93,95,95,95,95,95,
95,95,95,97,0,0,0,0,419,471,421,0,0,0,0,0,0,0,0,0,0,0,443,444,469,471,471,471,472,0,0,0,0,93,95,97,0,0,0,0,0,0,268,269,95,95,95,95,
95,95,95,97,193,0,0,0,393,394,446,447,0,0,0,0,0,0,0,0,0,43,45,45,45,45,45,45,47,0,0,0,443,93,95,49,45,47,0,0,0,0,0,93,95,95,95,95,
95,197,95,49,45,45,47,0,193,419,471,446,447,0,0,0,0,193,0,0,0,0,268,49,49,49,95,95,97,0,0,0,419,93,95,95,95,97,0,0,0,0,0,93,95,95,95,95,
95,95,95,95,95,95,49,45,45,45,45,45,47,0,0,382,384,384,386,0,0,0,0,294,93,95,95,95,97,0,0,0,43,143,145,353,145,147,0,0,0,0,0,93,95,95,95,95,
95,95,95,95,95,95,95,95,95,95,95,95,97,0,443,444,520,521,446,447,0,0,0,443,93,95,197,95,518,518,0,0,93,97,488,378,471,421,0,0,0,0,0,93,95,95,95,95,
95,95,95,95,95,207,309,309,309,211,95,95,49,45,45,45,545,546,45,45,45,45,45,45,49,95,95,95,261,446,447,518,518,97,471,471,396,397,0,0,0,0,0,93,95,95,95,95,
197,95,95,95,95,261,201,0,393,307,309,211,95,95,95,95,95,95,95,95,95,95,95,95,95,95,351,95,261,488,488,488,257,518,518,518,446,447,0,0,0,0,0,93,95,95,95,95,
95,95,95,95,95,261,0,0,0,419,469,307,309,353,309,309,309,309,349,309,309,309,353,309,309,309,376,309,311,488,488,488,257,97,444,471,471,421,0,0,0,0,443,93,95,95,95,95,
95,95,95,95,95,307,211,0,443,444,396,397,518,378,488,488,488,488,374,518,488,488,378,435,436,488,401,488,488,526,527,528,257,97,471,471,396,397,0,193,193,443,444,93,95,95,95,95,
95,95,95,199,95,95,261,443,444,469,421,0,393,394,488,488,488,488,488,488,488,488,434,486,436,488,488,488,488,551,552,553,257,97,471,396,397,43,45,45,45,45,45,49,49,49,95,95,
95,95,95,95,95,95,307,211,469,396,397,0,0,419,488,534,488,488,488,534,488,488,434,486,436,488,534,488,488,396,207,209,311,97,396,397,0,0,0,0,0,0,393,394,469,93,95,95,
95,95,95,95,95,95,95,307,209,211,0,0,0,419,488,488,488,488,488,488,488,488,434,435,436,488,488,488,207,209,311,95,95,97,397,0,0,0,0,0,0,0,0,393,394,93,95,95,
95,95,95,95,520,521,95,95,95,261,0,0,443,444,488,488,488,488,526,527,528,207,209,209,211,488,488,488,257,95,95,95,271,518,47,0,0,0,0,0,0,0,0,0,207,49,95,95,
95,95,95,95,545,546,95,95,95,261,0,0,468,434,435,436,488,488,551,552,553,257,95,95,261,488,488,488,257,95,95,271,272,0,0,0,0,0,0,0,0,0,0,518,257,95,95,95,
95,95,95,95,95,95,95,95,95,261,0,0,207,209,209,209,209,209,209,209,209,311,95,95,307,209,209,209,311,95,271,272,0,0,0,0,0,0,0,0,0,0,0,0,307,309,518,95,
95,95,95,207,309,309,309,309,309,311,0,0,257,95,95,95,95,95,95,95,95,271,145,145,145,349,95,95,95,95,97,0,0,0,0,0,0,0,0,0,0,0,0,0,443,351,257,259,
95,95,95,261,469,446,447,0,0,518,0,0,257,95,199,271,145,145,145,145,145,296,0,393,394,374,145,269,95,271,296,0,0,0,0,277,0,0,0,0,0,0,0,277,468,376,257,259,
95,95,95,261,469,469,446,447,0,0,0,0,307,309,309,518,471,471,396,397,0,0,0,0,419,469,469,93,95,97,0,0,0,43,45,45,278,278,278,278,278,278,278,45,211,401,257,259,
95,95,95,261,530,531,532,446,447,0,0,0,518,0,0,518,471,471,446,447,0,0,0,43,47,469,469,93,271,296,0,0,0,93,95,97,0,0,0,0,0,0,443,93,261,488,257,259,
95,95,199,261,555,556,557,469,472,0,0,0,0,0,0,419,471,43,384,47,0,0,0,0,393,394,469,93,272,0,0,0,193,93,95,83,64,65,0,0,0,443,444,93,261,488,257,259,
95,95,95,307,209,209,209,209,209,211,193,0,0,0,443,444,471,471,396,397,0,0,193,0,443,444,488,518,201,0,0,43,45,49,95,199,89,90,45,45,45,45,45,81,261,488,257,259,
95,95,95,95,197,95,95,95,95,307,209,45,47,0,393,394,471,471,472,0,0,43,45,45,47,469,469,447,0,0,43,49,95,95,95,95,95,95,95,95,95,95,95,95,261,488,257,259,
95,95,95,95,95,95,95,199,95,95,95,95,97,0,443,444,471,471,43,45,45,47,0,0,468,469,469,446,447,0,93,95,95,95,95,95,95,95,95,95,518,309,309,309,518,488,257,259,
95,95,95,95,95,95,95,95,95,95,95,95,49,47,468,469,471,471,472,0,0,0,0,443,444,469,49,471,43,45,49,95,95,95,518,309,309,518,95,518,311,488,434,435,436,488,257,259,
95,95,95,95,95,95,95,95,95,95,95,95,95,49,45,45,47,471,446,447,0,0,0,43,45,45,45,45,49,95,95,95,95,95,261,431,432,307,309,311,428,488,434,435,436,488,257,259,
95,95,95,95,95,95,95,95,95,95,95,95,95,95,95,95,49,45,45,45,45,45,45,49,95,95,95,95,95,95,95,259,259,95,261,456,457,488,534,488,453,488,434,428,518,488,257,259,
95,95,95,95,95,95,95,95,95,95,95,95,199,95,95,95,95,95,95,95,95,95,95,95,95,95,95,95,95,95,95,95,95,259,261,481,482,488,488,477,478,479,434,207,211,488,257,259,
95,95,95,95,95,95,95,95,95,95,95,95,95,95,95,95,95,95,95,95,95,95,95,95,95,95,95,95,95,95,95,95,95,95,518,209,209,209,209,209,209,209,209,518,518,209,518,259,
95,95,95,95,95,95,95,95,95,95,95,95,95,95,95,95,95,95,95,95,95,95,95,95,95,95,95,95,95,95,95,95,95,95,259,259,259,259,259,259,259,259,259,259,259,259,259,259
        ],
        "tile_map_offset":16,
        "tiling_sprite":null,
        "collision_map":null,
        "props":{
            "props":[
                ["rock",408,49],

                ["shrooms",272,337],["shrooms",400,417],

                ["spikes",208,119],["spikes",224,119],["spikes",240,119],

                ["spikes",288,119],["spikes",304,119],["spikes",320,119],["spikes",336,119],["spikes",352,119],
                ["spikes",368,119],

                ["spikes",400,263],["spikes",416,263],["spikes",432,263],

                ["spikes",192,263],["spikes",208,263],["spikes",224,263],["spikes",240,263],["spikes",256,263],
                ["spikes",272,263],["spikes",288,263],["spikes",304,263],["spikes",320,263],

                ["spikes",720,471],

                ["spikes-top",304,191],

                ["spikes-top",192,191],

                ["spikes-top",208,335],["spikes-top",224,335],

                ["spikes-top",272,367],["spikes-top",288,367],["spikes-top",304,367],

                ["spikes-top",288,415],["spikes-top",304,415],["spikes-top",320,415],["spikes-top",336,415],

                ["spikes-top",368,351],["spikes-top",384,351],

                ["spikes-top",352,399],["spikes-top",368,399],["spikes-top",384,399]
            ]
        }
      },{
        "id":"bg2",
        "cacheAsBitmap":true,
        "columns":48,
        "rows"   :32,
        "tile_set":"tileset",
        "tile_set_col":25,
        "tile_size":16,
        "offset_x":0,
        "offset_y":0,
        "parallax_speed_x":1,
        "parallax_speed_y":1,
        "scale":1,
        "tint":null,
        "tile_map":null,
        "tile_map_offset":16,
        "tiling_sprite":null,
        "collision_map":null,
        "prop_layer":true,
        "props":{
            "props":[
                ["tree",575,275]
            ]
        }
      },{
        "id":"bg3",
        "cacheAsBitmap":true,
        "columns":48,
        "rows"   :32,
        "tile_set":"tileset",
        "tile_set_col":25,
        "tile_size":16,
        "offset_x":-16,
        "offset_y":100,
        "parallax_speed_x":0.85,
        "parallax_speed_y":0.7,
        "scale":1,
        "tint":null,
        "tile_map":null,
        "tiling_sprite":"middle",
        "collision_map":null
      },{
        "id":"bg4",
        "cacheAsBitmap":true,
        "columns":48,
        "rows"   :32,
        "tile_set":"tileset",
        "tile_set_col":25,
        "tile_size":16,
        "offset_x":-16,
        "offset_y":0,
        "parallax_speed_x":0.7,
        "parallax_speed_y":0.35,
        "scale":1,
        "tint":null,
        "tile_map":null,
        "tiling_sprite":"back",
        "collision_map":null
      }]
}