{
  "id":"000",
  "textures":{
    "tileset_0":"client/assets/environment/tileset_0.png",
    "tileset":"client/assets/environment/tileset.png"
  },
  "texture_atlases":{
    "hearts":"client/assets/atlas/hearts.json",
    "items":"client/assets/atlas/items.json",
    "props":"client/assets/atlas/props.json",
    "sprites":"client/assets/atlas/sprites.json"
  },
  "layers":[{
    "id":"stage0",
    "columns":16,
    "rows"   :12,
    "tile_set":"tileset_0.png",
    "tile_set2":"tileset_0",
    "tile_set_col":8,
    "tile_size":16,
    "offset_x":0,
    "offset_y":0,
    "parallax_speed_x":1,
    "parallax_speed_y":1,
    "scale":1,
    "tint":null,
    "tile_map":[
      0,0,0,0,0,0,0,0,0,0,8,8,0,0,0,0,
      5,6,6,6,6,7,0,48,48,0,5,6,6,6,6,7,
      0,0,0,0,0,0,0,0,0,0,0,0,0,0,0,0,
      0,0,0,0,0,0,0,48,48,0,0,0,0,0,0,0,
      0,0,0,0,0,0,0,0,0,0,0,0,0,0,0,0,
      5,6,6,6,6,7,0,48,48,0,5,6,6,6,6,7,
      0,0,0,0,0,0,0,0,0,0,0,0,0,0,0,0,
      0,0,0,0,0,0,0,48,48,0,0,0,0,0,0,0,
      28,6,6,6,6,7,0,0,0,0,5,6,6,6,6,29,
      12,0,0,0,0,0,0,48,48,0,0,0,0,0,0,12,
      12,0,0,0,0,0,0,0,0,0,0,0,0,0,0,12,
      46,6,6,6,6,6,6,6,6,6,6,6,6,6,6,47],
    "collision_map":[
      0,0,0,0,0,0,0,0,0,0,0,0,0,0,0,0,
      13,13,13,13,13,11,0,15,15,0,3,13,13,13,13,13,
      0,0,0,0,0,0,0,0,0,0,0,0,0,0,0,0,
      0,0,0,0,0,0,0,15,15,0,0,0,0,0,0,0,
      0,0,0,0,0,0,0,0,0,0,0,0,0,0,0,0,
      13,13,13,13,13,11,0,15,15,0,3,13,13,13,13,13,
      0,0,0,0,0,0,0,0,0,0,0,0,0,0,0,0,
      0,0,0,0,0,0,0,15,15,0,0,0,0,0,0,0,
      15,13,13,13,13,11,0,0,0,0,3,13,13,13,13,15,
      10,0,0,0,0,0,15,0,0,0,0,0,0,0,0,2,
      10,0,0,0,0,0,0,0,0,0,0,0,0,0,0,2,
      0,13,13,13,13,13,13,13,13,13,13,13,13,13,13,0],
      "collectibles":[
        ["aaaa",0,32,16,16],
        ["aaab",32,32,16,16],
        ["aaac",64,32,16,16],
        ["aaba",160,32,16,16],
        ["aabb",192,32,16,16],
        ["aabc",224,32,16,16],
        ["aaca",0,95,16,16],
        ["aacb",32,95,16,16],
        ["aacc",64,95,16,16],
        ["bb",160,0,10,10],
        ["acda",164,95,16,16],
        ["acdb",196,95,16,16]
      ],
      "spawns":[[0,"patrol",186,110,1,1],
      [0,"patrol",40,57,1,1],
      [0,"patrol",48,0,1,1],
      [0,null,128,157,1,1]]
  },{
    "id":"bg0",
    "columns":20,
    "rows"   :15,
    "tile_set":"tileset_0.png",
    "tile_set2":"tileset_0",
    "tile_set_col":8,
    "tile_size":16,
    "offset_x":-8,
    "offset_y":-8,
    "parallax_speed_x":0.8,
    "parallax_speed_y":0.6,
    "scale":1.1,
    "tint":"0x505050",
    "tile_map":[0,8,0,0,0,0,4,0,0,0,0,0,0,0,0,0,0,0,8,0,
      8,8,2,3,0,13,14,0,0,0,0,0,0,0,0,0,8,8,8,8,
      8,1,8,11,0,21,8,0,0,0,48,0,0,0,0,8,8,13,7,0,
      6,14,19,8,0,48,8,4,0,0,13,6,6,15,15,6,6,22,0,48,
      0,21,14,8,0,0,5,13,6,6,22,0,0,23,22,0,0,0,0,0,
      0,0,21,15,6,6,6,22,0,0,0,0,0,12,0,0,0,0,0,8,
      0,0,0,12,0,0,0,0,0,0,0,0,13,16,0,4,0,0,1,3,
      0,0,0,21,14,0,0,0,4,0,48,0,23,16,4,20,0,0,17,19,
      0,48,0,0,12,0,0,0,12,0,0,0,23,34,16,8,8,6,6,6,
      0,0,0,0,12,0,48,0,12,0,0,48,8,24,20,8,8,0,0,0,
      6,14,0,4,39,0,0,8,12,0,4,0,12,0,0,8,0,0,0,0,
      0,8,15,39,19,0,8,8,13,6,22,0,21,4,0,0,0,13,6,6,
      8,8,24,19,0,0,5,15,22,0,0,4,0,20,0,0,13,12,34,34,
      8,12,0,8,4,0,0,12,0,0,0,12,0,0,8,0,5,24,6,7,
      0,12,0,0,12,0,8,23,14,0,48,12,0,0,0,0,0,0,0,0],
    "collision_map":null
  },{
    "id":"bg1",
    "columns":24,
    "rows"   :18,
    "tile_set":"tileset_0.png",
    "tile_set2":"tileset_0",
    "tile_set_col":8,
    "tile_size":16,
    "offset_x":-16,
    "offset_y":-16,
    "parallax_speed_x":0.6,
    "parallax_speed_y":0.36,
    "scale":1.2,
    "tint":"0x505050",
    "tile_map":[32,32,32,32,32,32,40,40,32,32,32,32,32,32,32,32,32,32,32,40,32,32,32,32,
      32,40,32,32,32,32,32,32,32,32,32,40,32,32,32,32,32,32,32,32,32,32,32,32,
      32,32,32,32,32,32,32,40,32,32,32,32,32,32,32,32,32,32,32,32,40,32,32,32,
      32,32,32,40,32,32,32,32,32,32,32,32,32,40,32,32,32,32,32,32,32,32,32,32,
      32,32,32,32,32,32,32,32,32,32,32,40,32,32,32,32,32,32,32,32,32,32,32,32,
      32,32,40,32,32,32,32,32,32,32,32,32,32,32,32,40,32,32,32,32,32,32,32,32,
      32,32,32,32,32,32,32,32,32,32,32,32,32,32,32,32,32,32,32,32,32,32,32,32,
      32,32,32,32,32,32,32,40,32,32,40,32,32,32,32,32,32,32,32,32,32,32,32,32,
      32,32,40,32,32,32,32,32,32,32,32,32,32,32,32,32,32,32,32,32,40,32,32,40,
      32,32,32,32,32,32,32,32,32,32,32,32,32,32,40,32,32,32,32,32,32,32,32,32,
      40,32,32,32,32,32,40,32,32,32,32,32,32,32,32,32,32,32,32,32,32,32,32,32,
      32,32,32,32,32,32,32,32,32,40,32,32,32,32,32,32,32,32,40,32,32,40,32,32,
      32,32,40,32,32,32,32,32,32,32,32,32,32,32,32,32,32,32,40,32,32,32,32,32,
      32,32,32,32,32,32,32,40,32,32,32,32,40,32,32,32,32,32,32,32,32,32,32,32,
      32,32,40,32,32,32,32,32,32,32,32,32,32,32,32,32,32,40,32,32,32,32,32,32,
      32,32,32,32,32,32,40,32,32,32,32,32,32,32,32,32,32,32,32,32,32,32,32,32,
      32,40,32,32,32,32,32,32,32,32,32,32,40,32,32,32,32,32,32,32,32,32,32,32,
      32,32,32,40,32,32,32,32,32,32,32,32,32,32,32,32,32,32,32,40,32,32,32,40],
    "collision_map":null
  }]
}